1111
A101
1C21
1P01
1E11
1111