1111
1C01
1001
1E11
1P0
1111