1111
1C01
1001
1E10
1P11
1111