1111111
100CPE0
1000CC0
1111111