11111111111111111111
100P000CC00100000001
11000000C0001111C001
1011100000000C000001
10000110000C00000C01
1000C0000C0011100001
10E000C000000C001101
11111111111111111111