11111111111111111111
1000000CC00100000001
110000C0C0001111C001
1011100E00000C000001
10000110000C00000C01
1000C0000C0011100001
1P0000C000000C001101
11111111111111111111